NO textures/simonkraft/wet_sponge.xpm
SO textures/simonkraft/wet_sponge.xpm
WE textures/simonkraft/wet_sponge.xpm
EA textures/simonkraft/wet_sponge.xpm

F 164,169,20
C 153,204,255

01111111111111111111110
01010000010000000000010
01010101010111111100010
01000101000100000100010
01111101011111010111010
01000001010001010000010
01011111010111011111110
01010000010101000001010
01010111110101111101010
01010100010101000101010
01011101010101010101010
01000001010100010100010
01111111010111110111010
01000001010001000100010
01011101011101011101110
01010001000001000101010
01010111111111110101010
01000100000000000100010
01010101110111111111010
01N10000010000000000010
01111111111111111111110

