F 76,76,76
C 99,99,99

NO textures/simonkraft/cobblestone.xpm
SO textures/simonkraft/cobblestone_01.xpm
WE textures/simonkraft/mossy_cobblestone1.xpm
EA textures/simonkraft/cobblestone_02.xpm

11111111111111111110
10W10010010010000010
10110000010000010010
10010010011111011110
10011110000010010010
10000000000000010010
10011111111110010010
11110000000000010110
10000000010000000010
11111111111111111110

