NO textures/simonkraft/respawn_anchor_side0.xpm
EA textures/simonkraft/respawn_anchor_side2.xpm
SO textures/simonkraft/respawn_anchor_side4.xpm
WE textures/simonkraft/respawn_anchor_side3.xpm

C 0,0,0
F 255,165,40

11111
10001
10001
100N1
11110