   WE                            textures/wolfenstein/eagle.xpm 
NO      textures/wolfenstein/grey_stone.xpm



SO textures/wolfenstein/red_brick.xpm

F   69, 222, 199

EA textures/wolfenstein/mossy.xpm



C 235, 198, 52

1111
10W1
1111
