NO textures/wolfenstein/grey_stone.xpm
SO textures/wolfenstein/purple_stone.xpm
WE textures/wolfenstein/red_brick.xpm
EA textures/wolfenstein/wood.xpm

F 220,100,0
C 225,30,0

        1111111111111111111111111
        1000000000110000000000001
        1011000001110000000000001
        1001000000000000000000001
111111111011000001110000000000001
100000000011000001110111111111111
1111011111111101110000001000100
1111011111111101110101001000100
1100000011010101110000001000100
1000000000000000110000001000100
1000000000000000110101001000100
11000001110101011111011110N0111
11110111 1110101 10111101000100
11111111 1111111 11111111111100
